1111111111111111111111111111111111
1111111111111111111111111111111111
11111111111P11111101111111111E1111
111111111111111111C111111111111111
1111111111111111111111111111111111