1111111111111111111111111111111111
1111111111100000000001111011110011
11111111111P11111100000CC0011E1C11
111111111111100000C101110100000011
1111111111111111111111111111111111