1111111111111111111111111111111111
1E0000000000000C00000C000000000001
11100101001000001010010001P0010101
1E1000000000000C00000C001010000001
1E1000000000000C00000C000100000001
1111111111111111111111111111111111