111111111111111111111111111111111111111111111111111111111111111111111111111111
110000000010000111100C00000011100000000000000111000000001100000000000000000001
1000010C00100000100C010000C001E0C000000000000000000000000000000000000000000001
11100000000010100000000000000100C000000000000C00000000000000000000000000000001
1000010100100000101C000000C00100C00000000000C000000000000000000000000000000001
10100100101010100010010000000100C000000000000000000000000000000000000000000001
1000010000C1111000100000C1110100C000000000000000000000000000000000000000000001
10100100101010100010010000000100C000000000000000000000000000000000000000000001
1000010000C1111000100000C1110100C000000000000000000000000000000000000000000001
10100100101010100010010000001100C000000000000000000000000000000000000000000001
10100100101010100010010000000100C000000000000000000000000000000000000000000001
1000010000C1111000100000C1110000C000000000000000000000000000000000000000000001
10100100101010100010010000000100C000000000000000000000000000000000000000000001
1000010000C1111000100000C1110000C000000000000000000000000000000000000000000001
10100100101010100010010000000100C000000000000000000000000000000000000000000001
1000010000C1111000100000C1110100C000000000000000000000000000000000000000000001
10100100101010100010010000001100C000000000000000000000000000000000000000000001
101001C0101010100010010000000100C000000000000000000000000000000000000000000001
1000010000C1111000100000C1110000C000000000000000000000000000000000000000000001
10100100101010100010010000000100C000000000000000000000000000000000000000000001
1000010000C1111000100000C1110000C000000000000000000000000000000000000000000001
10100100101010100010010000000100C000000000000000000000000000000000000000000001
100001P000C1111000100000C1110000C000000000000000000000000000000000000000000001
111111111111111111111111111111111111111111111111111111111111111111111111111111