11111111111111111111111111111111
110000000010000111100C0000001111
1000010000100000100C010000C00101
111000000000101000000000E0000101
1000010100100000101C000000C00001
10100100101010100010010000000101
1P00010000C1111000100000C1110001
11111111111111111111111111111111