1111111111111111111111111111111111
101100001000000C00000C000000000001
1000001000010000010100100000001001
1111111111111111111111111111111011
1P000000EC00C0000000000000000000C1
1111111111111111111111111111111111