1111111111111111111111111111111
1C000000000000000000000000000E1
1000000000000000000000000000001
1111111111111111111111110111111
1111100000000000000000000011111
1111100000000000000000000011111
1111100000000000000000000011111
11111P0001111111111111100011111
1111100001111111111111100011111
1111100000001111111000000011111
1111100000001111111000000011111
1111100000000000000000000011111
1111100000000000000000000011111
1111100000000000000000000011111
1111100000000000000000000011111
1111100000000000000000000011111
1111100000000000000000000011111
1111100000000000000000000011111
1111100000000000000000000011111
1111100000000000000000000011111
1111111111111111111111111111111