111111111111111111111111111111111111111111111111111111111111111111111111
100000000000101111111010000010000100001000001001111100111111101110000001
100000000000101000000010010010001010001100001010000010000100000100000001
100000000000101000000010010010010001001010001010000000000100000100000001
100000000000101111100010010010100000101001001010000000000100000100000001
100000100000101000000010010010111111101000101010000000000100000100000001
100000100000101000000010010010100000101000011010000010000100000100000001
100000011111001111111001101100100000101000001001111100000100001110000001
100000000000000000000000000000000000000000000000000000000000000000000001
10000000000000000000000000000010000000011111000000000000000000000E000001
100000000000000000000000000000100001001000001000000000000000000000000001
100000000000000000000000000000100001000000001000000000000000000000000001
100000000000000000000000000000100001000111110000000000000000000000000001
10000000000000000000000000000011111110100000000000000000000000000C000001
100000000P00000000000000000000000001001000000000000000000000000000000001
100000000000000000000000000000000001001111111000000000000000000000000001
100000000000000000000000000000000000000000000000000000000000000000000001
100000000000000000000000000000000000000000000000000000000000000000000001
100000000000000000000000000000000000000000000000000000000000000000000001
100000000000000000000000000000000000000000000000000000000000000000000001
100000000000000000000000000000000000000000000000000000000000000000000001
100000000000000000000C0C000C000000C000000CCCCCC0CCCCCC000000000000000001
10000000000000000000C000C00C000000C000000C0000000000C0000000000000000001
1000000000000000000C00000C0C000000C000000CCCCC00000C00000000000000000001
1000000000000000000CCCCCCC0C000000C000000C00000000C000000000000000000001
1000000000000000000C00000C0C000000C000000C0000000C0000000000000000000001
1000000000000000000C00000C0CCCCCC0CCCCCC0CCCCCC0CCCCCC000000000000000001
100000000000000000000000000000000000000000000000000000000000000000000001
1000000000000CCCCC00CCCCCC0C0000C00CCCC00CCCCC000CCCC00000CCC00000000001
1000000000000C0000C0C000000C0000C0C0000C0C0000C0C000000000CCC00000000001
1000000000000C0000C0CCCCC00CCCCCC0C0000C0C0000C00CCCC000000C000000000001
1000000000000C0000C0C000000C0000C0C0000C0CCCCC0000000C000000000000000001
1000000000000C0000C0C000000C0000C0C0000C0C000C00C0000C0000CCC00000000001
1000000000000CCCCC00CCCCCC0C0000C00CCCC00C0000C00CCCC00000CCC00000000001
111111111111111111111111111111111111111111111111111111111111111111111111